###############
# H       w   #
# ######### # #
# #   p     # #
# #  M   ###  #
# #   #     # #
# ##  x   h   #
#    #######  #
# M     #     #
#     G       #
###############
