#################
#####p       M  # 
############### #
########G    ## #
#     ###### ## #
#p###M       ## #
# ### ######### #
#H###        w  #
########  #######