#################
#####G       M  # 
############### #
########p    ## #
#     ###### ## #
#p###M       ## #
# ### ######### #
#H###        w  #
########  #######