#######################
#       x             #
#            w        #
#      H              #
#  M            h     #
#                     #
#    M     M          #
#           p     G   #
#                     #
#######################
